111111111111111111111
1C0000CCCC000000000C1
1001101000000111C0011
1P00101000001E0C0CC01
111111111111111111111