111111111111111111111
1C0000001C100000000C1
1001101001000111C0011
1P00101000001E0C0CC01
111111111111111111111
