111111111111111111111
1P00000C0E00C000000C1
111111111111111111111