1111111111111
1P000E0000001
1000000000001
1111111111111