1111111111111
1PE000C000001
10000000E0001
1111111111111