1111111111111
1P0C0E000C0C1
1111111111111