1111111111111
1P000EC000001
1000000000001
1111111111111