1111111111111
1PE0000010001
10000C0000001
1111111111111
