1111111111111
1P00000010001
10001100C00E1
1111111111111
