1111111111111
1P00000010001
1C00110CC00E1
1111111111111
