1111111111111111111111111111111111111111111111111111111111111111
1C0000CCCC000000000C000000C111111100000000CCC0000C0000000C110001
1000101000000001C001100001000000000000100000000001C1100001100001
100010100100000100011C000100000001110001001000000111110000000011
1P001E100000000CCC01000C000011C11CCCC11CCCCC11100000000000001101
1C00111CCC010000000C000000011111110000000000C0110C0001000C10C001
1000101000000001C0011000010000000000001C000000011011100001101111
1C0000C1CC010100000C0000100110C11100000000CC10000C00000000111001
1000101000010111C001100001000C0000000010000011000110100C00000101
1C00C00CCC0000C1000C00C0000111111100000000C0C0000C00000000000011
1000101000110101C00110000100001C000000100C00011100111001C111C001
1111111111111111111111111111111111111111111111111111111111111111