1111111111
1P00000C01
1011111011
100C001001
1011111011
10000000E1
1000000001
1000000001
1000000001
1000000001
1000000001
1111111111